######################
#B   #       #       #
# ## ##### ### ##### #
#    #     #   #     #
#### # ### ##### ##### 
#    #   #     #     #
### ####### ### ### ##
#         #   # #    #
##### ### ##### ##### #
#     # #     #       #
### ### ##### ####### #
#   #     #       #   #
# ### ### ####### ### #
# #   #   #         # #
# ##### ### ####### ###
#       #   #     #   #
# ####### ### ##### ###
#       #     #       #
######################A